10 10 10 10 10 10 10 10 10 10 10 10 10 10 10 10 10 10 10 10 10 12 10 10 10 10 10 10 10 10 10 10 10 10 10 10 13 10 10 10 10 14 10 10 10 10 10 10 10 10
10 10 12 10 10 10 10 10 10 10 10 10 10 10 10 10 10 10 10 10 10 10 10 10 10 10 10 10 10 10 10 12 10 10 10 10 10 10 10 10 11 10 10 10 10 12 10 10 10 10
10 10 10 10 10 10 10 11 10 10 10 10 10 10 10 10 10 14 10 10 10 10 10 13 10 10 10 10 10 10 10 10 10 10 10 10 10 12 10 10 10 10 10 10 10 10 13 10 10 10
44 44 44 44 44 44 44 44 44 44 44 44 44 44 44 44 44 44 44 44 44 44 44 44 44 44 44 44 44 44 44 44 44 44 44 44 44 44 44 44 44 44 44 44 44 44 44 44 44 44
45 45 45 45 45 45 45 45 45 45 45 45 45 45 45 45 45 45 45 45 45 45 45 45 45 45 45 45 45 45 45 45 45 45 45 45 45 45 45 45 45 45 45 45 45 45 45 45 45 45
10 10 10 10 10 10 10 10 10 10 10 10 10 10 10 10 10 10 10 10 10 10 10 10 10 10 10 10 10 10 10 10 10 10 10 10 10 10 10 10 10 10 10 10 10 10 14 10 10 10
10 10 10 10 13 10 10 10 10 10 10 10 10 14 10 10 27 30 16 16 34 31 10 10 10 10 10 10 10 10 10 10 10 10 10 10 10 10 10 10 10 12 10 10 10 10 10 10 10 10
10 10 10 10 10 10 10 10 10 10 10 10 10 10 10 27 17 39 39 39 39 15 31 10 10 10 10 10 10 10 10 10 10 10 10 10 10 10 10 10 13 10 10 10 10 10 10 10 10 10
10 10 10 10 14 10 10 10 10 10 10 10 10 10 10 29 39 39 39 39 39 39 33 10 10 10 10 10 10 10 10 10 10 10 10 10 10 10 10 10 10 10 10 11 10 10 10 10 10 10
10 10 10 10 10 10 10 10 10 10 10 10 10 10 10 35 39 39 39 39 39 39 18 10 10 13 10 10 10 10 11 10 10 10 10 10 10 10 10 10 10 14 10 10 10 10 10 10 10 10
10 10 10 10 10 10 10 10 12 10 10 10 10 10 10 22 39 39 39 39 39 39 18 10 10 10 10 10 10 10 10 10 10 10 10 10 10 10 10 10 10 10 10 10 10 10 10 10 10 10
10 10 10 10 10 10 10 10 10 10 10 10 13 10 10 19 38 39 39 39 39 39 18 10 10 10 10 10 10 10 10 12 10 10 10 10 13 10 10 10 10 10 10 10 12 10 10 13 10 10
10 10 10 10 10 10 10 10 10 10 10 10 10 10 10 10 19 38 39 39 39 25 26 10 10 10 10 10 10 10 14 10 10 10 10 10 10 10 10 10 10 10 10 10 10 10 10 10 10 10
10 10 10 13 10 10 10 10 10 10 10 10 10 10 10 10 10 19 38 39 36 24 23 10 10 10 10 11 10 10 10 10 10 10 10 10 12 10 10 10 10 10 10 10 10 10 10 10 10 10
10 10 10 10 10 10 10 10 10 10 10 13 10 10 10 10 10 10 35 39 18 10 10 10 10 10 10 10 10 10 10 10 10 10 10 10 10 10 10 10 10 10 10 10 14 10 10 10 10 10
10 10 10 12 10 10 11 10 10 10 10 10 10 10 10 10 10 10 35 39 15 31 10 10 10 10 10 10 10 10 10 10 10 10 10 10 10 10 10 10 10 10 10 10 10 10 27 30 16 10
10 10 10 10 10 10 10 10 11 10 10 10 10 10 10 11 10 10 22 39 39 33 10 10 10 10 10 10 10 10 10 10 10 10 10 10 10 10 10 10 10 13 10 27 30 16 17 39 39 10
10 10 10 10 10 10 10 10 10 10 10 10 10 10 10 10 10 13 19 38 39 18 10 10 13 10 10 27 30 16 16 16 16 34 31 27 30 16 16 34 31 27 30 17 39 39 39 39 36 10
10 10 13 10 10 14 10 10 10 10 10 10 10 13 10 10 10 10 10 35 39 18 10 27 30 16 16 17 39 39 39 39 39 39 15 17 39 39 39 39 15 17 39 39 39 36 37 24 23 10
10 10 10 10 12 10 10 10 10 10 10 14 10 10 10 10 10 10 27 17 39 15 16 17 39 39 39 39 39 36 37 37 38 39 39 39 39 36 38 39 39 39 39 36 24 23 10 10 10 10
10 10 10 10 10 10 10 27 30 16 16 16 16 16 34 31 27 30 17 39 39 39 39 39 39 36 37 37 24 23 10 10 19 20 37 37 24 23 19 20 37 37 24 23 10 10 10 10 10 10
10 10 10 10 10 10 10 29 28 39 39 39 39 39 39 15 17 39 39 39 36 37 37 37 24 23 10 10 10 10 10 10 10 10 10 10 10 10 10 10 10 10 10 10 10 10 13 10 10 10
10 10 10 16 16 34 31 35 39 36 37 37 37 38 39 39 39 39 36 24 23 10 10 10 10 14 10 10 10 10 10 10 10 10 10 10 10 10 10 10 10 10 14 10 10 10 10 10 10 10
10 10 39 39 39 39 15 17 39 18 10 10 10 19 20 37 37 24 23 10 10 10 10 10 10 10 10 10 10 10 10 10 10 10 12 10 10 10 10 10 10 10 10 10 10 10 12 10 10 10
10 10 37 37 38 39 39 39 39 26 10 10 10 10 10 10 10 10 10 10 10 10 10 10 10 10 10 10 10 10 10 10 10 10 10 10 10 10 10 10 10 10 10 10 10 10 10 10 10 10
10 10 10 10 19 20 37 37 24 23 10 10 10 10 10 10 10 10 10 10 14 10 10 10 10 10 10 10 10 10 10 10 10 10 10 10 10 10 10 12 10 10 10 10 10 10 10 10 10 10
10 10 10 13 10 10 10 10 10 10 10 12 10 10 10 10 10 10 10 10 10 10 10 10 10 10 10 10 10 10 10 10 10 10 10 10 10 10 10 10 10 10 10 10 10 10 10 10 10 10
10 10 10 10 10 10 10 10 10 10 10 10 10 10 10 10 14 10 10 10 10 10 10 10 10 10 10 10 10 11 10 10 10 10 10 10 10 10 10 10 10 10 10 13 10 10 10 10 10 10
10 10 10 10 10 10 10 10 10 10 10 10 10 11 10 10 10 10 10 10 10 10 10 10 10 10 10 10 10 10 10 10 10 10 10 10 10 10 10 14 10 10 10 10 10 10 10 10 10 10
10 10 13 10 10 10 12 10 10 10 10 10 10 10 10 10 10 10 10 10 10 10 10 10 10 10 10 10 10 10 10 10 10 10 10 10 10 10 10 10 10 10 10 10 10 10 10 10 10 10
10 10 10 10 10 10 10 10 10 10 10 10 10 10 10 10 10 10 10 10 10 10 10 11 10 10 10 10 10 10 10 10 10 10 10 10 10 10 10 10 10 10 10 10 10 12 10 10 10 10
10 10 10 10 10 10 10 10 10 14 10 10 10 13 10 11 10 10 10 10 10 10 10 10 10 10 10 10 10 10 10 10 10 10 10 10 10 10 10 12 10 10 10 13 10 10 10 10 10 10
10 10 12 10 10 10 11 10 10 10 10 10 10 10 10 10 10 10 10 10 10 10 10 10 10 10 10 10 10 10 10 10 10 10 10 10 10 10 10 10 10 10 10 10 10 10 10 10 10 10
10 10 10 10 10 10 10 10 10 10 10 10 10 10 10 13 10 10 10 10 10 10 10 10 10 10 10 10 10 10 10 10 10 10 10 10 10 10 10 10 10 10 10 10 10 10 10 10 10 10
10 10 10 10 10 10 13 10 10 10 10 10 10 10 10 10 10 12 10 10 10 10 10 10 10 10 12 10 10 10 10 10 10 10 10 10 10 10 10 10 10 13 10 10 10 10 10 10 10 10
10 10 10 10 10 10 10 10 10 10 10 10 10 10 10 10 10 10 10 10 10 10 10 10 10 10 10 13 10 10 10 10 10 10 10 10 10 10 10 10 10 10 10 10 10 10 10 10 10 10
10 10 10 11 10 10 10 10 10 10 10 12 10 10 10 10 10 10 10 10 10 10 10 10 10 10 10 10 10 10 10 12 10 10 10 10 10 10 10 10 10 10 10 11 10 10 10 10 13 10
10 10 10 10 10 10 10 10 14 10 10 10 10 10 10 10 10 10 10 10 10 10 14 10 10 10 10 10 10 10 10 10 10 13 10 10 10 10 10 10 10 10 10 10 10 10 10 10 10 10
10 10 13 10 10 10 11 10 10 10 10 10 10 10 10 10 10 10 10 10 10 10 10 10 10 12 10 10 10 10 10 10 10 10 10 10 10 10 10 10 10 10 10 10 10 10 10 10 10 10
10 10 10 10 10 10 10 10 10 10 10 12 10 10 10 10 10 10 10 10 10 10 10 10 10 10 10 10 13 10 10 10 10 10 10 10 10 10 10 10 10 10 10 10 12 10 10 10 10 10
10 10 10 10 10 10 10 10 10 13 10 10 10 11 10 10 10 10 10 10 10 10 10 10 10 10 10 10 10 10 10 10 10 10 10 10 10 10 12 10 10 10 10 10 10 10 10 10 10 10
10 10 10 10 10 10 10 14 10 10 10 10 10 10 10 10 10 10 14 10 10 12 10 10 10 10 10 10 10 10 10 10 12 10 10 11 10 10 10 10 10 10 14 10 10 10 10 10 10 10
10 10 10 11 10 10 10 10 10 10 10 10 10 10 10 10 10 10 10 10 10 10 10 10 10 10 10 10 10 10 10 10 10 10 10 10 10 10 10 10 13 10 10 10 10 10 10 10 10 10
10 10 10 10 10 12 10 10 10 10 10 10 10 10 10 11 10 10 10 10 10 10 10 13 10 10 10 10 11 10 10 10 10 10 10 10 10 13 10 10 10 10 10 10 10 10 10 12 10 10
10 10 10 10 13 10 10 10 10 10 10 10 10 10 10 10 10 10 10 10 10 10 10 10 10 10 10 10 10 10 10 10 10 14 10 10 10 10 10 10 10 10 10 10 10 10 10 10 10 10
44 44 44 44 44 44 44 44 44 44 44 44 44 44 44 44 44 44 44 44 44 44 44 44 44 44 44 44 44 44 44 44 44 44 44 44 44 44 44 44 44 44 44 44 44 44 44 44 44 44
45 45 45 45 45 45 45 45 45 45 45 45 45 45 45 45 45 45 45 45 45 45 45 45 45 45 45 45 45 45 45 45 45 45 45 45 45 45 45 45 45 45 45 45 45 45 45 45 45 45
10 10 10 10 10 10 10 10 10 13 10 10 10 10 10 10 14 10 10 10 13 10 10 10 10 10 10 10 10 10 10 10 10 13 10 10 10 10 10 10 10 10 10 10 10 10 10 10 14 10
10 10 10 10 10 10 10 10 10 10 10 12 10 10 10 10 10 10 10 10 10 10 10 10 13 10 10 10 10 10 10 10 10 10 14 10 10 10 10 10 10 10 10 14 10 10 10 10 10 10
10 13 10 10 10 10 10 10 10 10 10 10 10 10 10 10 10 10 10 10 10 10 10 10 10 10 10 10 10 10 10 10 10 10 10 10 10 10 10 10 10 10 10 10 10 10 10 10 10 10